gov.br = br.gov.meugovbr
Carteira de Trabalho Digital = br.gov.dataprev.carteiradigital
Carteira Digital de Trânsito = br.gov.serpro.cnhe
Meu INSS – Central de Serviços = br.gov.dataprev.meuinss
Cadastro Único = br.gov.dataprev.meucadunico
Conecte SUS = br.gov.datasus.cnsdigital
Meu Imposto de Renda = br.gov.fazenda.receita.irpf
MEI = br.gov.fazenda.receita.mei
Sinesp Cidadão = br.gov.sinesp.cidadao.android
Receita Federal = br.gov.economia.receita.rfb
SINE Fácil = br.gov.dataprev.sinefacil
Pessoa Física = br.gov.fazenda.receita.pessoafisica
SouGov.br = br.gov.serpro.sougov
Exército Brasileiro = com.goodbarber.exercitobr
ID Jovem = com.idjovem2
Anatel Consumidor = br.com.anatel.consumidor
NFSe Mobile = br.gov.nfsemobileemissor
Calculadora do Cidadão = br.gov.bcb.mobile.android.calculadoracidadao
eSocial Doméstico = eSocial.Android
Tesouro Direto = br.gov.fazenda.tesouro.td
Agendamento = br.gov.fazenda.receita.agendamento
e-Processo = br.gov.fazenda.receita.eprocesso
Consumidor.gov.br = br.com.consumidor
ENEM = br.gov.inep.inepenem
Fiscalização Senatran = br.gov.serpro.denatran.fiscalizacaodenatran
e-SUS Vacinação = br.gov.saude.esusaps.vacinacao
Diário Oficial da União (DOU) = br.gov.in.doumobile
AVAMEC Mobile = br.gov.mec.avamecmobile
Cidadãogov.br = br.gov.mpdg.siconvcidadao
Sinesp Agente de Campo = br.gov.sinesp.agentedecampo
UM POR TODOS REVISTAS = com.msp.revistadigital
SEI = br.gov.mpdg.sei
VLibras = com.lavid.vlibrasdroid
e-SUS Território = br.gov.saude.acs
Coronavírus - SUS = br.gov.datasus.guardioes
Compras.gov.br = br.gov.serpro.comprasNetMobile
DPU Cidadão = br.gov.sisdpu
ID Digital Marinha = br.mil.mar.sim.iddigitalmarinha
Bolsista CAPES = br.gov.capes.bolsista
Dinheiro Brasileiro = br.gov.bcb.mobile.android.appnotas
Dívida Aberta = br.gov.serpro.pgfn.devedores
Portal Cidadão - DNIT = br.gov.dnit.servicos.portalcidadao
Clique Escola = br.gov.cliqueescola
ANEEL Consumidor = br.gov.aneel.ouvidoria
Inmet = com.inmet
Força Aérea Brasileira = com.app.foraareabrasileira
PRF Brasil = br.gov.prf.prfbrasil
Caixa Postal UFS = br.ufs.nti.cxmobile
RNTRC ANTT = com.antt.rntrc
IBGE = br.gov.ibge
eUFS Aluno = br.ufs.nti.sigaa
SPUApp = serpro.corporativo.lowcode.SPUApp
Direitos Humanos Brasil = br.gov.direitoshumanosbrasil
AVAMEC Dados de curso = br.gov.mec.avamec.mobiledadosdecurso
Anatel Serviço Móvel = br.com.mais2x.anatelsm
TáxiGov DF = br.com.originalsoftware.taxifonecliente.vipServiceClub
NFSe Cidadão = br.gov.nfsemobiletomador
Boletim ao Mar = boletim.ao.mar
SINE Fácil Empregador = br.gov.dataprev.sinefacil.empregador
Declara Agua = br.gov.ana.declaraagua
Gestão e-SUS APS = br.gov.saude.esusaps.gestao
DNIT na Estrada = br.com.dnit.dnitnaestrada
UFMT = br.ufmt.sti.app
UFERSApp = br.edu.ufersa.ufersapp
SISCAER = br.gov.dpf.siscaer
EB Facilidades = br.mil.eb.eb_facilidades
ANTT Cidadão = com.antt.appcidadao
SIGAA Docente UFPB = br.ufpb.sti.apps.app_sigaa_docente
IFAL Mobile = br.gov.ifalmobile
Calculadora do Investidor = br.gov.calculadoradoinverstidor
Verificador ICP-Brasil = br.gov.iti.verificadoricpbrasil
Autuações Ambientais Federais = br.gov.ibama.portalautuado
IFRO Mobile = br.edu.ifro.mobile.suap
Identidade Funcional SUSP = com.identidadefuncional
UFRGS Mobile = com.cpd.ufrgsmobile
SVPM+ = br.mil.mar.svpm.website
e-SUS AB Atividade Coletiva = br.gov.saude.ac
Soutec = br.gov.mec.soutec
IFS Digital = br.edu.ifs.ifsdigital
Gestorgov.br = br.gov.mpdg.siconv
IFG Mobile = br.com.renanrodrigues.ifgmobile
FPL BR = br.com.atech.sigmaandroid
Conexão DNIT = br.gov.conexaodnit
Meu INCApp = io.inca
Mães do Brasil = br.gov.mmfdh.maesunidas
UFPR VIRTUAL = br.ufpr.ufprvirtual
UFSM Digital = br.ufsm.cpd.ufsmdigital
UFMT - AVA Graduação = br.ufmt.sti.moodle
Fiscalgov.br = br.gov.mpdg.siconvfiscalizacao
Marinha = com.goodbarber.marinhabr
Auto Infração Eletrônico (AIe) = br.gov.ibama.aie
TáxiGov PR = net.taxidigital.taxigovparana
Jornada do Estudante = br.gov.mec.jornada.estudante
Madeiras Comerciais do Brasil = com.s2softeam.madeirascomerciaisbrasil
UFV mobile = br.ufv.m
IF Goiano Mobile = br.edu.ifgoiano.mobile.app
ID Valida Marinha = br.mil.mar.sim.idvalidamarinha
SISS-Geo = siss.ui
SST Fácil = br.gov.fundacentro.sstfacil2
periodicos = br.gov.capes.periodicos
meu IFSC = br.edu.ifsc.dtic.meuifsc
Guia de Direitos e Serviços = br.gov.mmfdh.guiadireitoseservicos
Acumulus = br.gov.mec.vlabAcumulus
MonitorAr = br.gov.mma.monitorar
Game da Cidadania = br.gov.cgu.cidadania
CertCrono Inmetro - Certificad = br.gov.inmetro.cronotacografo
Passe Livre para pessoas caren = io.ionic.passelivre
AVAMEC Meus Desempenhos	= br.gov.mec.avamec.mobilemeusdesempenhos
Viva bem = br.gov.datasus.vivabem
Aguas Brasil = br.gov.ana.anadigital
CNPq = br.cnpq.app
TáxiGov SP = net.taxidigital.taxigovsp
HU Digital = br.gov.ebserh.hudigital
InvestSUS = br.gov.ms.investsus
Conexão PGFN = br.gov.pgfn.conexaopgfn
SNCR = br.gov.serpro.sncr
CENSO LOCALIZA = br.gov.inep.censolocaliza
AVAMEC Dados Institucionais = br.gov.mec.avamec.mobiledadosinstitucionais
Hidroweb = br.gov.ana.hidroweb
Um Por Todos - Estudante II = com.msp.umportodos2
Ebserh = br.gov.ebserh.institucional
UTI Neonatal = br.gov.utiNeonatal
Normas = br.gov.serpro.sijut
Um Por Todos - Estudante III = com.msp.umportodos3
Um Por Todos - Estudante I = com.msp.umportodos
Corretores SUSEP = br.gov.susep.corretores
RU UFC = br.ufc.restaurante
TáxiGov RJ = net.taxidigital.taxigovrj
Marinha Cultural = com.goodbarber.marinhacultura2
Alquímico = br.gov.mec.vlabAlquimico
App Unipampa = br.edu.unipampa.app
Enigmas de Yucatàn = br.gov.mec.vlabEnigmasDeYucatn
InfraBR = br.gov.infrabr
Combo: Ligações Químicas = br.gov.mec.vlabCombo
Real JG Facilities = br.gov.realjgfacilities
TATU: Turismo e Acessibilidade = br.gov.turismo.apptatu
Anatel Comparador de Ofertas = br.gov.anatel.comparador
BORA - Políticas Públicas = br.gov.enap.bora
Planalto Legis = br.gov.presidencia.planalto.legis
FioLibras = br.gov.fiocruz.fiolibras
PRF Peregrino = br.gov.prf.prfperegrino
AVAMEC Fórum = br.gov.mec.avamec.mobileforum
Onde está o dinheiro da saúde? = br.com.eadfiocruzpe.OEDS.development
SIMPLES MENTE: insights compor = lk.argon.simplesmenteapp
Emendas Parlamentares - MS = br.gov.datasus.emendasparlamentares
HepaticApp = br.gov.hepaticapp
FPL BR - EFB = br.gov.decea.fplbr.efb
MedSUS = com.datasus.MedSUSAPP
Ajuda Auditor Beta = br.gov.beta.ajudaauditor
Sala 360 = br.gov.mcom.sala360
